NO ./textures/north.xpm
SO ./textures/south.xpm

W ./textures/west.xpm
E ./textures/east.xpm

F 164,169,20
C 153,204,255

111111111111111111111
101000001000000000001
101110101110101110111
101000100000100010101
101011111111111010101
100010000000000010001
101010111011111111101
1N1000001000000000001
111111111111111111111
