NO ./maps/textures/north.xpm
SO ./maps/textures/south.xpm

W ./maps/textures/west.xpm
E ./maps/textures/east.xpm


F                   244,255,180
C             130,130,255


  1111111
  1100001111111111111111111
111111111000000000000000011
1100000000000010111111
1100N0010111100100    1
 1111111111 111111    1