
NO ./mandatory/textures/north.xpm
SO  ./mandatory/textures/south.xpm
WE ./mandatory/textures/west.xpm
F      20,20,20


EA ./mandatory/textures/east.xpm


C   200,200,200



1111
10N01
1111



