
NO ./textures/north.xpm
SO./textures/south.xpm
WE      ./textures/west.xpm
F20,20,20


EA ./textures/east.xpm


C200,200,200



1111
10N01
1111



