
NO ./bonus/textures/xpm/finalgraywallshade1.xpm
SO ./bonus/textures/xpm/finalgraywallshade1.xpm
WE ./bonus/textures/xpm/finalgraywallshade2.xpm
EA ./bonus/textures/xpm/finalgraywallshade2.xpm

C 100,100,100
F 44,44,44


1111111
1000001
10N0701
1000001
1111111

