NO ./bonus/textures/xpm/finalgraywallshade1.xpm
SO ./bonus/textures/xpm/finalgraywallshade1.xpm
WE ./bonus/textures/xpm/finalgraywallshade2.xpm
EA ./bonus/textures/xpm/finalgraywallshade2.xpm

C 100,100,100
F 44,44,44

                                11111111111
                       11111111110000000001
                       10000000000000000001
                       10011111110060000001
                       1001     11111011111
       111121111121111 1001         101
       100000000000001 1001        10001
 11211 1006000000000011100111     1000001
 20602 3000000000000000000001    100000001
 20002 1007000000060011111111     1000001
 11011 100000000000001             10001
  101  111121101121111              161
 11011       101                    101   
 10001 11311 101         4444411511119111151144444
 100011100011101         4000410007000000000140004
 300000000000001         4000080000000000600000004
 100011100011101         4000410000006000000140004
 10001 11311 101         4454430000000000000244544
 10001       101         4000410060000000600140004
 10001 111111101111111   4000410000000000000140004
 10001 1000000000000011114454420000000000000344544
 10001 1000000600000000000000410060000000600140004
 10001 1000000000000011112000000000000000000000004
 30001 1000000S0000001   4000410000000000000140004
 10001 100000000000001   4444411111111111111144444
 10001 100000000000003    
 10001 100000000000071
 10001 111111191111111
 10001      10001
 1000111111110001
 1000000000000781
 1121111111111211


