NO ./bonus/textures/xpm/finalgraywallshade1.xpm
SO ./bonus/textures/xpm/finalgraywallshade1.xpm
WE ./bonus/textures/xpm/finalgraywallshade2.xpm
EA ./bonus/textures/xpm/finalgraywallshade2.xpm

C 100,100,100
F 44,44,44

                               11111111111
                      11111111110000000001
                      10000000000006000001
                      10011111110000000001
                      1001     11111011111
      111111111111111 1001         101
      100000000000001 1001        10001
11211 1000000000000011100111     1000001
20002 1000000000000000000001    100000001
20002 1000000000000011111111     1000001
11011 100000000000001             10001
 101  111111101111111              101
11011       101                5   101   5
10001 11111 101         4444411011110111101144444
10001110001 101         4000410000000000000140004
30000000001 101         4000000000000000000000004
10001110001 101         4000410000000000600140004
10001 11111 101         4454430000000000000244544
10001       101         4000410000000000000140004
10001 111111101111111   4000410000000000000140004
10001 100000000000001   4454420006000000000344544
10001 100000000000001   4000410000000000000140004
100011100000000000001   4000500000000000000000004
300000000000600000001   400041000000N000000140004
100011100000000000001   4444411111111111111144444
10001 100000000000003
10001 100000000000001
10001 111111101111111
10001      10001
1000111111110001
1000600000000001
1121111111111211