NO ./bonus/textures/xpm/finalgraywallshade1.xpm
SO ./bonus/textures/xpm/finalgraywallshade1.xpm
WE ./bonus/textures/xpm/finalgraywallshade2.xpm
EA ./bonus/textures/xpm/finalgraywallshade2.xpm

C 100,100,100
F 44,44,44

                                11111111111
                       11111111110000000001
                       10000000000000000001
                       10011111110060000001
                       1001     11111011111
       111111111111111 1001         101
       100000000000001 1001        10001
 11211 1000060000000011100111     1000001
 20002 1000000000000000000001    100000001
 20002 1000000000000011111111     1000001
 11011 100000000000001             10001
  101  111111101111111              101
 11011       101                5   101   5
 10001 11111 101         4444411011119111101144444
 100011100011101         4000410000000000000140004
 300000000000001         4000090000000000000000004
 100011100011101         4000410060000000000140004
 10001 11111 101         4454430000000000000244544
 10001       101         4000410000000000000140004
 10001 111111101111111   4000410000600000000140004
 10001 1000700000000011114454420000000000000344544
 10001 1000000000000000000000410000000070000140004
 1000111000000007000011110000000000000000000000004
 300000000000000000001   40004100000N0000000140004
 100011100000000000001   4444411111111111111144444
 10001 100006000000003
 10001 100000000000001
 10001 111111101111111
 10001      10001
 1000111111110001
 1000000000000001
 1121111111111211


